6
50
0  0  0  0  0  0  0  0  0  0  0  0  0  0  0  0  0  0  0  0  0  0  0  0  0  0  0  0  0  0  0  0  0  0  0  0  0  0  0  0  0  0  0  0  0  0  0  0  0  23
0  0  0  0  0  0  11 0  0  0  0  0  0  0  0  14 0  0  0  0  0  0  0  0  0  0  0  0  0  0  0  0  0  0  0  0  0  0  17 17 0  0  0  0  0  0  0  0  23 23
0  0  10 0  0  0  17 17 0  12 0  0  0  0  0  17 0  0  13 0  0  0  0  0  0  15 0  0  0  0  0  0  0  0  0  17 17 19 20 20 18 0  0  0  0  0  0  0  0  23
17 17 17 17 17 19 20 20 18 17 0  0  0  0  19 20 18 17 17 17 17 23 24 17 17 17 17 17 17 0  0  0  0  17 17 20 20 20 22 22 20 18 17 17 17 17 17 17 17 23
20 20 20 20 20 20 22 22 20 20 18 17 17 19 20 22 20 20 20 20 20 20 20 20 20 20 20 20 20 20 18 17 19 20 20 22 22 22 22 22 22 20 20 20 20 20 20 20 20 20
21 21 21 21 21 21 21 21 21 21 22 22 22 22 21 21 21 21 21 21 21 21 21 21 21 21 21 21 21 21 22 22 22 21 21 21 21 21 21 21 21 21 21 21 21 21 21 21 21 21



